2,270	1,0 	1,0 	1,0 	1,0 	1,0 	1,0 	1,0 	1,0 	1,0 	1,0 	1,0 	1,0 	2,0
1,270	1,0 	1,0 	1,0 	0,0 	1,0 	1,0 	1,0 	1,90 	1,90 	0,0 	1,0 	1,0 	1,90
1,270 	1,0 	1,0 	1,0 	0,0 	1,0 	1,0 	1,0  	1,90 	1,90 	0,0 	1,0 	1,0 	1,90
1,270	1,0 	1,0 	1,0 	0,0 	1,0 	1,0 	1,0  	1,90 	1,90 	0,0 	1,0 	1,0 	1,90
1,270	1,0 	1,0 	1,0 	0,0 	1,0 	1,0 	1,0  	1,90 	1,90 	0,0 	1,0 	1,0 	1,90
1,270 	0,0 	0,0 	0,0 	1,180 	1,180 	1,180 	1,270 	0,0 	0,0 	0,0 	1,0 	1,0 	1,90
2,180	4,180 	4,180 	1,180 	1,180 	1,180 	1,180 	2,180 	1,180 	1,180 	1,180 	3,180 	3,180 	2,90